22 0 0 0 0 0 0 0 0 0 0 0 0 0 0 0 0 0 0 0 0 0 0 0 0 0 0 0 0 0 0 0 0 0 0 0 0 0 0 0 0 0 0 0 0 0 0 0 0 0 
0 0 0 0 0 0 0 0 0 0 0 0 0 0 22 22 0 0 0 0 0 0 0 0 0 0 0 0 0 0 0 0 0 22 0 0 0 0 22 0 0 0 0 0 22 0 0 0 0 0 
0 0 22 22 22 0 22 22 0 0 0 0 22 22 0 0 0 22 0 0 0 0 0 0 0 22 0 0 0 0 0 0 0 0 0 0 0 0 0 0 22 0 0 0 0 0 0 0 0 22 
0 0 0 0 22 22 0 0 0 0 0 0 0 0 22 0 0 0 0 0 0 0 0 0 0 0 0 22 0 0 22 0 0 0 0 0 0 0 22 0 0 0 0 0 0 0 0 22 22 0 
0 0 0 0 22 0 0 0 0 0 0 0 0 0 22 0 22 0 22 22 0 0 0 0 0 0 0 0 0 0 0 0 0 0 0 0 0 0 0 0 0 0 0 0 0 0 0 0 0 0 
0 0 0 0 0 0 0 0 0 0 22 0 0 0 22 22 0 0 0 0 0 22 22 22 0 0 0 0 0 0 0 0 0 0 0 0 0 0 0 0 0 0 0 0 0 0 0 0 0 0 
0 0 22 0 0 0 0 0 0 0 0 0 0 0 0 0 0 0 0 0 0 0 0 0 0 0 0 0 0 0 0 0 0 0 0 0 0 0 0 0 0 0 0 0 0 0 0 0 0 0 
0 0 0 0 12 9 9 9 9 9 9 9 9 9 9 9 9 9 9 9 9 9 9 9 9 9 9 9 9 9 9 9 9 9 9 9 9 9 9 9 9 9 9 9 9 9 9 9 13 22 
0 0 0 0 10 0 22 0 0 0 0 0 0 0 0 0 0 0 0 0 0 0 0 0 0 22 0 0 0 0 0 0 0 0 0 0 0 0 0 0 0 0 0 0 0 0 0 0 13 0 
0 0 22 0 10 0 0 22 22 0 0 22 0 0 0 0 0 22 0 0 0 0 0 0 0 22 0 0 0 0 0 0 0 0 22 0 0 0 0 0 0 0 0 0 0 22 0 0 13 0 
0 0 0 0 10 0 22 22 0 0 0 0 0 0 0 0 0 0 0 0 0 0 22 0 0 0 0 0 0 0 0 0 0 0 0 0 0 0 0 0 0 38 43 43 43 43 42 0 13 0 
0 22 0 0 10 0 22 22 0 0 22 0 0 0 0 0 0 0 0 0 0 0 22 0 0 0 22 0 0 0 0 0 0 0 22 0 0 22 0 0 0 36 39 39 39 39 40 0 13 0 
0 0 0 0 10 0 0 0 0 0 0 0 0 0 0 0 0 0 22 0 0 0 0 0 0 0 0 0 38 43 43 43 43 43 43 43 43 43 43 43 43 39 39 39 39 39 40 0 13 0 
0 0 0 0 10 0 0 38 43 43 43 42 0 22 0 0 0 0 0 0 0 0 0 22 22 0 0 0 36 39 35 35 35 35 35 35 35 35 35 35 35 39 39 39 39 39 40 0 13 0 
22 0 22 0 10 0 0 36 39 39 39 40 0 0 0 0 0 0 0 0 0 0 0 0 0 0 0 0 36 40 0 0 0 0 0 0 0 0 0 0 0 37 35 35 35 35 41 0 13 0 
0 0 22 0 10 0 0 36 39 39 39 39 43 43 43 43 43 43 43 43 43 43 43 43 43 43 43 43 39 40 0 0 0 0 0 0 22 0 0 22 0 0 0 0 0 0 0 0 13 22 
0 0 0 0 10 0 0 36 39 39 39 39 35 35 35 35 35 35 35 35 35 35 35 35 35 35 35 35 39 40 0 0 0 0 0 0 22 0 0 22 0 0 0 0 0 0 0 0 13 22 
0 0 0 0 10 0 0 36 39 39 39 40 0 0 0 0 0 0 0 0 0 0 0 0 0 0 0 0 36 40 0 0 0 0 0 22 0 0 0 0 0 22 0 0 0 22 0 0 13 0 
0 22 22 0 10 0 0 37 35 35 35 41 0 0 0 0 0 0 22 22 0 0 0 0 0 0 0 0 36 40 0 0 0 0 0 0 0 0 0 0 0 0 0 0 0 0 0 0 13 0 
0 0 0 0 10 0 0 0 0 0 0 0 0 0 0 0 0 0 0 22 22 0 0 0 22 0 0 0 36 40 0 0 0 0 22 22 0 0 0 22 0 0 0 0 22 0 0 0 13 0 
0 0 0 0 10 0 0 0 0 0 0 0 0 0 22 0 0 0 0 0 0 0 0 0 0 0 0 0 36 40 0 0 0 0 0 0 0 0 0 0 22 0 0 0 0 0 0 0 13 22 
0 0 0 0 10 0 0 0 0 22 0 0 0 0 0 0 0 0 0 0 0 0 0 22 0 0 0 0 36 40 0 0 0 0 0 0 0 0 0 0 0 0 0 0 0 0 22 0 13 0 
0 0 0 0 10 0 22 22 22 0 0 0 0 0 0 0 0 0 0 0 0 0 0 0 0 0 0 0 36 40 0 0 0 0 0 0 0 0 0 0 0 0 0 0 0 0 0 0 13 0 
0 22 0 0 10 0 0 0 0 0 22 0 22 22 0 0 0 0 0 0 0 0 0 0 0 0 0 0 36 40 0 0 0 0 0 0 0 0 0 0 0 0 0 22 0 0 22 0 13 0 
0 0 0 0 10 0 0 0 0 0 0 0 0 0 0 22 0 0 0 0 0 0 0 22 0 0 22 0 36 40 0 0 0 0 0 0 0 22 0 0 0 0 0 0 0 0 0 0 13 0 
0 0 0 0 10 0 0 0 0 22 0 0 0 0 0 0 0 0 0 0 0 0 0 0 0 0 0 0 36 40 0 22 0 0 0 0 0 0 0 0 0 22 0 0 0 0 0 0 13 0 
22 22 22 0 10 22 0 0 0 0 0 0 0 0 0 0 0 0 0 0 0 0 0 0 0 0 22 0 36 40 0 22 22 0 0 0 0 0 0 0 0 0 22 0 0 0 0 0 13 0 
0 0 0 0 10 0 0 0 0 0 0 22 0 0 0 0 0 0 22 0 0 0 0 0 0 0 0 0 36 40 0 0 0 0 0 0 0 0 0 0 0 0 0 0 0 22 0 0 13 0 
0 0 0 0 14 0 0 0 0 0 0 0 0 0 0 0 0 0 0 0 0 0 0 0 0 0 0 0 36 40 0 0 0 0 0 22 0 0 0 0 0 0 0 0 0 0 0 0 13 0 
0 0 0 0 12 9 9 9 9 9 9 9 9 9 9 9 9 9 9 9 9 9 9 9 9 9 11 0 36 40 0 12 9 9 9 9 9 9 9 9 9 9 9 9 9 9 9 9 11 22 
0 0 0 22 0 0 0 0 0 0 0 0 0 14 22 0 0 0 22 0 0 0 0 22 0 0 0 0 36 40 22 0 0 22 14 0 0 0 22 0 0 0 0 0 0 0 0 0 0 0 
0 0 0 22 0 0 0 0 0 0 0 0 0 13 0 33 34 38 43 43 43 43 43 43 43 43 43 43 39 39 42 6 5 0 13 0 0 0 0 0 0 0 0 0 0 0 0 0 22 0 
0 0 0 0 0 0 0 0 22 0 0 22 0 13 0 17 22 36 39 39 39 39 39 39 39 39 39 39 39 39 40 0 16 0 13 0 0 0 0 0 0 0 0 0 22 0 0 0 0 0 
0 0 0 0 0 22 0 0 0 0 0 0 0 13 0 0 0 36 39 39 39 39 39 39 39 39 39 39 39 39 40 22 0 0 13 0 0 0 0 0 0 0 0 0 0 0 0 22 0 0 
0 22 0 0 0 0 0 0 0 0 0 0 0 13 0 29 30 36 39 39 39 39 39 39 39 39 39 39 39 39 40 2 1 0 13 0 0 22 0 0 0 0 0 0 0 0 0 0 0 0 
0 0 0 0 0 0 0 0 0 0 0 0 0 13 0 17 0 36 39 39 39 39 39 39 39 39 39 39 39 39 40 0 16 0 13 0 0 0 0 0 0 0 22 0 0 0 0 0 0 0 
0 0 22 0 0 0 0 0 0 0 22 0 0 13 22 0 0 37 35 35 35 35 39 39 39 39 35 35 35 35 41 22 0 0 13 0 0 0 0 0 0 0 0 0 0 0 22 0 0 0 
0 0 0 0 0 0 0 0 0 0 0 0 22 13 0 0 0 22 0 0 0 0 36 39 39 40 0 0 0 0 22 0 0 22 13 0 0 22 0 0 0 0 0 0 0 0 0 0 0 0 
0 0 0 0 0 0 22 0 0 0 0 22 0 12 9 13 0 0 0 20 21 0 36 39 39 40 0 19 18 0 0 0 13 9 11 0 0 0 0 0 0 0 0 0 0 0 0 0 0 0 
0 0 0 0 0 0 0 0 0 0 0 0 0 0 0 13 22 0 0 17 0 22 36 39 39 40 0 0 16 22 0 0 13 0 0 0 0 22 0 0 0 0 0 0 0 0 0 0 0 0 
0 0 0 0 0 0 0 0 0 0 0 0 0 0 0 13 0 0 0 0 0 0 36 39 39 40 0 0 0 0 0 22 13 0 0 0 0 0 0 0 0 0 0 0 22 0 0 0 0 0 
0 0 0 22 0 0 0 0 0 0 22 0 0 0 0 13 0 0 0 25 26 0 36 39 39 40 22 24 23 0 0 0 13 0 0 0 0 0 22 0 0 0 0 0 0 0 0 0 0 0 
0 0 0 22 0 0 0 0 0 0 0 0 0 22 0 13 0 22 0 17 0 0 36 39 39 40 0 0 16 0 22 0 13 0 0 0 0 0 0 0 0 0 0 0 0 0 0 0 0 0 
0 0 22 22 0 0 0 0 0 0 0 0 0 0 0 13 0 0 0 0 0 0 36 39 39 40 0 0 0 0 0 0 13 0 0 0 0 0 0 0 0 0 0 22 0 0 0 0 0 0 
0 0 0 0 0 0 0 0 0 22 0 0 0 22 0 13 0 0 0 50 51 0 36 39 39 40 22 49 48 0 0 22 13 0 0 22 0 0 0 0 0 0 0 0 0 0 0 22 0 0 
0 0 0 0 0 0 0 0 0 0 0 0 0 0 0 13 22 0 0 17 22 0 36 39 39 40 0 22 16 0 0 0 13 0 0 0 22 0 0 0 0 0 0 0 0 0 0 0 0 0 
0 0 0 0 0 0 0 0 0 0 0 0 0 0 0 13 0 22 0 0 0 0 36 39 39 40 0 0 0 0 0 0 13 0 0 0 0 0 0 0 0 0 0 0 0 0 0 0 0 0 
22 22 0 22 0 0 0 0 0 0 0 22 22 0 0 13 0 0 0 46 47 0 36 39 39 40 0 45 44 0 22 0 13 0 0 0 0 22 22 22 0 0 0 0 22 22 0 0 0 0 
0 0 0 0 0 0 0 0 0 0 0 0 0 22 0 13 0 0 0 17 0 22 36 39 39 40 0 0 16 0 0 0 13 0 0 0 0 0 0 0 0 0 0 0 0 0 0 0 0 0 
0 0 0 0 0 0 0 0 0 0 0 0 0 0 0 12 9 9 9 9 9 9 9 9 9 9 9 9 9 9 9 9 11 0 0 0 0 0 0 0 0 0 0 0 0 0 0 0 0 0 
